NO textures/malatia.xpm
SO textures/maykil.xpm
WE textures/suliman.xpm
EA textures/beko.xpm
F 200,200,255


C 200,200,200





1111111111111
1000000001011
1000000000011
1000000000001
1000000000011
1000010000001
1000010000001
1010000000001
11000W0000001
1111111111111




