EA textures/beko.xpm

NO textures/malatia.xpm


WE textures/suliman.xpm

SO textures/maykil.xpm




F 200,200,0
C 200,200,200


111111111111
100000000001
100000000001
100000000001
100000000001
100001000001
100000Q00001
101001000001
10001W000001
111111111111