EA asd
NO asddas
SO asdasd
WE sadsdadsa

F 200,200,200
C 200,200,200


111111111111111
100000Z000   0 1  
100000000 0 0 0 1
10101010011101111
10101010101001011
1111 1 1 1 1 1111













