EA asd
NO asddas
SO asdasd
WE sadsdadsa

F 200,200,200
C 200,200,200


  11111111111111111111
0000000001111111111 
10000000010111011111
10101010011101111111
10101010101001011111
11111111111111111111