EA asd
NO asddas
SO asdasd
WE sadsdadsa

F 200,200,200
C 200,200,200


  11111111111111111111
1000000001111111111 1 001
10000000010111011101
10101010W1110111001
1010101010100101110011
11111111111111111111