EA asd 
N asddas
S asdasd
W sadsdadsa



1111111111111
1001233213121
1123321213312231
123123213213123123