EA textures/wall1.xpm
NO textures/wall2.xpm
SO textures/wall3.xpm
WE textures/wall4.xpm

F 239,240,238
C 163,253,255


111111111111111111111
101001000000000000011
100010000000000000011
101000000000000000011
101000000000000000011
10100W000000000000001
101000000000000011111
111111111111111111111
