EA asd
NO asddas
SO asdasd
WE sadsdadsa

F 200,200,200
C 200,200,200


1111111111111
1001233213121
1123321213312231
123123213213123123
1111 1 1 1 1 1111













