NO textures/malatia.xpm
SO textures/maykil.xpm
WE textures/suliman.xpm
EA textures/beko.xpm

F 220,100,0
C 225,30,0

        1111111111111111111111111
        1000000000110000000000001
        1011000001110000000000001
        1001000000000000000000001
111111111011000001110000000000001
100000000011000001110111111111111
111101111111110111000000100011
111101111111110111010100101111
110000001101010111000000101111
100000000000000011000000101111
100000000000000011010100100011
11000001110101011111011110N0111
11110111 1110101 1011110100011
11111111 1111111 1111111111111
