NO textures/malatia.xpm
SO textures/maykil.xpm
WE textures/suliman.xpm
EA textures/beko.xpm

F 220,100,0
C 225,30,0

        1111111111111111111111111
        1000000000110000000000001
        1011000001110000000000001
        1001000000000000000000001
111111111011000001110000000000001
10000000000000001110111111111111
11110111111111011100000010001
1111011111111101110101001011101
110000001101010111000000101111
10000000000000000000000101111
100000000000000011010100000011
11000001110101011111011110N0111
11110111 1110101 1011110100011
11111111 1111111 1111111111111
